+-+-+-+-+-+-+-+-+-+-+
S       |     |     |
+ +-+-+ + +-+ + +-+ +
|   | |   |   | |   |
+-+ + +-+-+ +-+ + +-+
|   | | |       |   |
+ +-+ + + +-+-+-+-+ +
|     |   |   |     |
+ +-+-+-+-+ +-+ +-+-+
| | |     |         |
+ + + +-+ +-+-+ +-+ +
| | | |   |     |   |
+ + + +-+-+ +-+-+ +-+
|   | |   |   | |   |
+ +-+ + + +-+ + +-+ +
|   | | |   | | |   |
+-+ + + +-+ + + + +-+
| | | |   |   | |   |
+ + + +-+ +-+-+ +-+ +
|   |         |     E
+-+-+-+-+-+-+-+-+-+-+
