+-+-+-+-+-+-+-+-+-+-+-+-+-+-+-+-+-+-+-+-+-+-+-+-+-+-+-+-+-+-+
S     |       |   |   |   |   |   |   |         | |       | |
+ +-+ +-+-+-+ + + + + + + + + + + + + + +-+ + + + + +-+-+ + +
|   |   |     | |   | | |   | | | | |   |   | |   | |   |   |
+-+ +-+ +-+ +-+ +-+-+ + +-+-+ + + + +-+-+ +-+-+-+ + + + + +-+
| |   |       |   | | |   |   | | |   |   |     | | | | |   |
+ +-+ +-+-+-+ +-+ + + +-+-+ +-+ + +-+ +-+-+-+-+ + + + + +-+-+
|     |   |     |   |     |     |   |   |     | | | | | |   |
+ +-+-+ +-+ +-+ +-+-+-+-+ +-+ +-+-+ +-+ + +-+ + + + +-+ + + +
| |   |     |         | |   | |     |   |   | |   | |   | | |
+ +-+ +-+-+-+-+-+-+-+ + +-+ + + +-+-+ +-+-+-+ +-+ + + +-+ + +
|         |   |   |   |     | | |     |     |   |   | |   | |
+-+-+-+-+ +-+ +-+ +-+-+ +-+-+-+ +-+-+-+ +-+ +-+ + +-+ +-+-+ +
|         |   |   |   |       |       | |   |   | |   |   | |
+ +-+-+-+-+ +-+ + + + +-+-+-+ +-+-+-+ + + +-+ +-+ +-+ + + + +
|   |     |   | |   | |     |     |     |   |   | |   | |   |
+-+ + +-+ + + + + +-+ + + +-+-+ + + +-+-+-+ +-+ + + + +-+ +-+
|   |   |   | | | |   | |   |   | | |     | |       |   |   |
+ + +-+-+ +-+ + + +-+-+ +-+ + +-+-+ + +-+-+ +-+ +-+-+-+ +-+ +
| | |     |   | |     |   | |     | |           |       |   |
+ + + +-+-+ +-+ +-+-+ +-+ + +-+ + + +-+ +-+ +-+-+ +-+-+-+ + +
| | | |     |   |     |   |     |   |   |   |     |       | |
+ +-+ +-+ +-+ +-+ +-+-+ +-+-+-+-+-+-+-+-+ +-+ +-+-+ + +-+-+ +
|   |   |   | |   |     |     |           |   |   | |     | |
+-+ +-+ + +-+ + +-+-+ +-+ +-+-+ +-+-+-+-+-+ +-+ + + +-+-+ + +
|   |   |     |   |       |   |     |     | |   | |     | | |
+ +-+ +-+-+-+-+ + + +-+-+-+ + +-+ + + + + + +-+-+ +-+-+-+ +-+
| |       |     |   | |   | | |   |   | | |   |     |   |   |
+ + +-+-+-+ +-+-+-+-+ + + + + + +-+-+-+-+ +-+ + +-+-+ + +-+ +
| |     |   |     |     | | | |       |   | | |     | |   | |
+ + +-+ + +-+-+ + +-+-+-+ +-+ +-+-+-+-+ +-+ + + +-+ + + +-+ +
| | |   | |   | |   |   |   |     |     |   |   | | | |     |
+ + + +-+ +-+ +-+-+ + + +-+ +-+-+ + +-+-+ +-+-+-+ + + +-+-+ +
|   |   |     |   | | |   |     |   |   |     | |   | |     |
+-+-+-+ +-+-+-+ + + + +-+ +-+ + +-+-+ + + +-+ + +-+ + + +-+-+
|   |   |     | |   |   | |   | | |   | |   | |   | | | |   |
+ +-+ +-+-+-+ + +-+-+-+-+ + +-+ + + +-+ +-+-+ + + + + + + + +
| |   |     |           | | | |   | |         | | |   |   | |
+ + +-+ + + +-+ +-+ +-+ + + + +-+ + +-+-+-+-+-+ + +-+-+-+-+ +
|       | | |   |   |     | |     |             |       |   |
+-+ +-+-+ +-+ +-+ +-+ + +-+ + +-+-+-+-+-+-+-+-+-+-+-+-+ + +-+
|   |   |     | | |   |   | |   |       |   |             | |
+ + + + +-+-+-+ + + +-+-+ + +-+ + +-+-+ + + + +-+-+-+-+ +-+ +
| | | | | |       |     |   |   | |     | |   |           | |
+ +-+ + + + +-+-+-+-+-+ +-+-+ + + + +-+-+ +-+-+ +-+-+-+-+-+ +
| |   |   |     | |     |     | | | |   |   | |   |       | |
+ + +-+-+ +-+-+ + + +-+-+-+-+-+-+ +-+ + +-+ + +-+ + +-+-+ + +
| | |   | |     |   |     |     |     |     | | | |   | | | |
+ + + + + +-+-+-+-+-+ +-+ +-+-+ +-+ +-+-+-+-+ + + +-+ + + + +
| | | | |   |         |   |   |     |     |       |   |   | |
+ + + + +-+ + +-+-+-+-+ +-+ + + +-+-+ +-+ + +-+-+-+-+-+-+ + +
|   | |     |     |     |   |   |     |   | |       | |   | |
+-+-+ +-+-+-+-+-+ +-+-+-+ +-+-+-+ +-+-+ +-+ +-+-+-+ + + + + +
|     |         |     |   |     | | |       |         | | | |
+ +-+-+-+-+-+-+ +-+-+ +-+-+ +-+ + + + +-+ +-+ +-+-+-+-+ +-+ +
| |     | |   | |   |   | |   | |   |   |   | |   |   | |   |
+ + +-+ + + + + + + +-+ + +-+ + +-+-+-+ +-+ + + + +-+ + + + +
| | |   |   | |   |     | |   | |       |   | | | |     | | |
+ + + +-+-+ + + +-+ +-+-+ + +-+ +-+-+ +-+ + + + + + + +-+ + +
|   |       |     |       |   |       |   |     |   |     | E
+-+-+-+-+-+-+-+-+-+-+-+-+-+-+-+-+-+-+-+-+-+-+-+-+-+-+-+-+-+-+
