+--+--+--+--+--+--+--+--+--+--+
S        |        |     |     |
+  +--+  +--+  +  +  +  +  +  +
|     |     |  |  |  |  |  |  |
+--+--+--+  +  +--+  +  +  +  +
|        |        |  |     |  |
+  +--+  +--+  +  +  +--+--+  +
|     |        |     |     |  |
+--+  +--+--+--+--+--+  +  +  +
|  |     |  |        |  |     |
+  +--+  +  +  +--+  +  +--+--+
|  |     |        |  |        |
+  +  +--+--+  +  +  +--+--+  +
|     |     |  |  |     |     |
+  +--+  +  +  +  +--+  +  +--+
|  |     |     |     |  |     |
+  +  +--+--+--+--+--+  +--+--+
|  |           |     |  |     |
+  +--+--+--+--+  +  +  +  +  +
|                 |        |  E
+--+--+--+--+--+--+--+--+--+--+
