+-+-+-+-+-+-+-+-+-+-+-+-+-+-+-+-+-+-+-+-+
S   |   |   |     | |   |       |     | |
+ + + + + + + +-+ + + + + + +-+ + + + + +
| |   |   | |   |     | | |   | | | | | |
+-+-+ +-+-+ +-+ +-+-+-+ + +-+ + +-+ + + +
|   | |       |   |   | |   | |     | | |
+ +-+ + +-+-+-+-+ + + + +-+-+ +-+-+-+ + +
|     |     |     | |   |   |     |     |
+-+-+-+-+-+ + +-+-+ +-+-+ + +-+-+ +-+ +-+
|     |   |   |   |       |     |   |   |
+ +-+ + + +-+-+ + + + + +-+-+-+ +-+ +-+-+
|   | | | |     |   | | |   | | |   |   |
+-+ + + +-+ +-+-+-+-+ + + + + + + +-+ + +
|   | |     |         | | |   | |   | | |
+ +-+ +-+-+-+ +-+-+-+-+ + +-+ + +-+ + +-+
| |   |   | | |         | |   |   | |   |
+ + +-+ + + + + +-+-+ +-+-+ +-+-+ + +-+ +
| |     |   | |   |   |   |     | | |   |
+ +-+-+-+-+-+ +-+-+ +-+ + +-+-+ + + + +-+
| |   |       |     |   |   |     |   | |
+ + +-+ +-+-+-+ +-+-+ +-+-+ +-+-+-+ +-+ +
| |     |       |   | | |         |   | |
+ +-+ +-+-+ +-+ +-+ + + + + +-+-+ +-+ + +
|     |   |   |       | | |     | | | | |
+-+-+-+-+ +-+-+-+-+ + + + +-+-+-+ + + + +
|     |   |         | |   |   |   | | | |
+ +-+ + +-+ +-+-+-+-+-+-+-+ + + +-+ + + +
|   | |     |               |   |   | | |
+ +-+ +-+-+-+-+ +-+-+-+-+-+-+-+-+ +-+ + +
|   |           |             |   |   | |
+-+ +-+-+-+-+-+-+ +-+-+-+ + +-+ +-+ +-+ +
|         | |   | | |     |         |   |
+-+-+-+ + + + + + + + +-+-+-+-+ +-+-+ + +
|       | |   | | |   |   |         | | |
+ +-+-+-+ +-+ + + + +-+ + +-+-+ +-+-+ + +
|     |   |   | | | |   | |   |       | |
+-+-+ + +-+ +-+ + + + +-+ + + +-+-+-+-+ +
|   | | | | | |   |   |     |       | | |
+ + + + + + + +-+-+-+-+-+-+-+ +-+-+ + + +
| |   |     |                 |     |   E
+-+-+-+-+-+-+-+-+-+-+-+-+-+-+-+-+-+-+-+-+
